What annoys me is that though I object , she insists on buying it .	しゃくにさわる の は 、 私 が 反対な のに 彼女 は それ を 買う といってきかない こと です 。
Bill is equal to the task of running the firm .	ビル は その 会社 を 経営 する 力 が ある 。
This is just what I wanted .	これ が ちょうど 私 が 欲しかった もの です 。
My sister 's work is teaching English .	姉 の 仕事 は 英語 を 教える こと です 。
I often get conjunctivitis .	よく 結膜炎 を 起こします 。
For God sent not his Son into the world to condemn the world ; but that the world through him might be saved .	神 が 御子 を 世 に 遣わされた の は 、 世 を 裁く ため でなく 、 御子 によって 、 世 が 救われる ため である 。
She was glad to have Jim say her name .	ジム に 自分 の 名前 を 呼ばれて 、 彼女 は うれしかった 。
It is no use trying to escape .	逃げよう とし たって だめ だ 。
I wish I were a bird .	ああ 、 私 は 鳥 で あれば よい のに 。
I know neither of them .	私 は 彼らの どちら も 知らない 。
She is much concerned about the result .	彼女 は その 結果 を 大変 気にしている 。
It is in the kitchen .	台所 に あります 。
We tried to persuade him .	説得 に 努めた 。
Get back to where you started .	おまえ が もと いた 故郷 へ 。
Japanese history is my favorite subject .	日本史 は 私の 好きな 教科 です 。
He is brave enough to go there by himself .	彼 は 一人で そこ に 行ける ほど 勇敢 だ 。
He brought me the news that our team had won .	彼 は 私 に 私達 の チーム が 勝った という 知らせ を 持ってきた 。
We attribute Edison 's success to intelligence and hard work .	エジソン の 成功 は 知性 と 勤勉 と の 結果 でもある 。
Keep an eye on the girls .	女の子 たち から 目を離さない ように 。
He invested 500,000 yen in stocks .	彼 は 株 に ５０ 万 円 投資 した 。
We had better protect our eyes from direct sunlight .	直射日光 から 目 を 守った 方がいい 。
I gave Mary a book .	私 は メアリー に 本 を 上げた 。
Along with thousands of others , he fled the country .	彼 は 他の 大勢の 人達 に 共に 亡命 した 。
What are you into these days ?	最近 は どんな 物 に 凝っている の ？
Not having been to Tokyo for a long time , I often got lost .	長いこと 東京 へ 行ってなかった ので 、 私 は たびたび 道に迷った 。
He was crying with pain when he broke his leg .	彼 は 足 を 折った とき 痛み で 叫んでいた 。
He waved goodbye to us .	彼 は 手を振って 我々 に 別れを告げた 。
On no account must you touch that switch .	どんなことがあっても 、 絶対に スイッチ に さわって は いけません 。
The work had been completed before I arrived .	その 仕事 は 私 が 到着 する 前 に 完成 していた 。
It will do you good to have a holiday .	休暇 を とる こと は 体 に 良い でしょう 。
Your tea will get cold if you do n't drink it now .	もし 今 飲ま なければ 、 あなた の お茶 は 冷めます よ 。
The dog growled at the strange man .	いぬ は 見知らぬ 男 に 向かって うなった 。
The traffic accident deprived the young man of his sight .	交通事故 で その 若者 は 失明 した 。
He conquered Mt. Everest .	彼 は エベレスト を 征服 した 。
This vast continent is abundant in fossil fuels .	その 広大な 大陸 は 化石燃料 が 豊富 だ 。
He put his thoughts on paper .	彼 は 自分 の 考え を 書き留めた 。
Though he tried hard , nothing changed .	彼 の 努力 にもかかわらず 、 すべて は 以前 と 変りなかった 。
My investments earn about 10 percent a year .	私の 投資 は 年 に １０ パーセント の 配当 が つく 。
The graduation ceremony took place on the morning of the first of March .	卒業式 は ３月 １日 の 朝 に 行われていた 。
Thank you for today .	今日 は どうもありがとう 。
It was fortunate that he passed it .	合格 した の は 幸運 だった 。
He canceled the appointment to attend the meeting .	彼 は 会合 に 出席 する という 約束 を 取り消した 。
Alex seemed to learn nouns such as `` paper , '' `` key '' and `` cork , '' and color names such as `` red , '' `` green '' and `` yellow . ''	アレックス は 「 紙  」 「 鍵 」 「 コルク 」 の ような 名詞 や 、 「 赤 」 「 緑 」 「 黄色 」 の ような 色 の 名 も 覚えた よう に 見えた 。
Work while you work , play while you play .	勉強 する 間 は 勉強 し 、 遊ぶ 間 は 遊べ 。
The young man robbed her of her bag .	若い 男 は 彼女の バッグ を 奪った 。
The older of the two daughters is in college .	ふたり の 娘 の うち 、 姉 の は ほう は 大学 に 在籍 中 である 。
He parked his car in front of the building .	彼 は 車 を その 建物 の 前 に 止めた 。
He freely praised her .	彼 は 手放し で 彼女 を 誉めた 。
He went abroad to raise fund for the project .	彼 は プロジェクト の 資金 を 集め に 外国 へ 行った 。
Please keep my place in this line .	この 列 の 私の 場所を取って おいて ください 。
He is content with his life as a baseball player .	彼 は 野球選手 として 自分 の 人生 に 満足 している 。
I am friendly with her .	彼女 と 仲がよい 。
His property was estimated at one hundred million dollars .	彼の 財産 は １ 億 ドル と 概算 された 。
Something is the matter with this TV set .	この テレビ は どこか 具合 が 悪い 。
I have just been to the station to see my uncle off .	私 は おじ を 見送り に 駅 まで 行ってきた ところ だ 。
See you later !	また 後で 。
Do you have any smaller sizes ?	もっと 小さい サイズ の 物 は あります か 。
They argue a lot , but for the most part they get along quite well together .	口論 も よく する けれども 、 たいてい は 皆 とても 仲良く やっている 。
Kidding ! I was simply invited to go out to dinner .	な〜んて 、 単に 外食 に 誘われた だけ です 。
I will go on ahead .	私 は 先 に 行きます 。
She is getting better by slow degrees .	彼女 は 徐々に 快方に向かっている 。
Ask him to sketch out his plan .	彼 に 計画 の 概略 を 述べて もらおう 。
We should obey our parents .	親 の 言う こと には 従う べき です 。
The weather forecast predicts whether it will rain or not .	天気予報 とは 雨 が 降る かどうか を 予測 する ものである 。
This form looks kind of complicated . Help me fill it out .	この 書式 は やや 複雑 そう だ 。 書きこむ の を 手伝って くれ 。
She is proud of being beautiful .	彼女 は 美しい 事 を 自慢 している 。
Huh ? What is this ? They 're not going to use my proposal ?	アン 。 なんて こと かしら 。 私の 案 が 採用 されない なんて 。
The game was put off until next Sunday .	その 試合 は 今度 の 日曜 まで 延期 された 。
Can you do as much ?	あなた も 同じような ことが出来ます か 。
He fell into a slumber inadvertently .	彼 は つい うとうとと した 。
How does he think it went ?	彼 は どう なった と 思います か 。
If it rains tomorrow , I 'll stay at home .	もし 明日 雨 ならば 、 私 は 家 に いる つもり です 。
A cargo vessel , bound for Athens , sank in the Mediterranean without a trace .	アテネ へ 向かう 一隻 の 貨物船 が 何の 痕跡 も 残さず に 地中海 で 沈没 した 。
She cried that she was innocent .	彼女 は 自分 は 無実 です と 叫んだ 。
I agree with him on that point .	僕 は その 点 で 彼 と 意見 が 合う 。
Your analysis of the situation is accurate .	あなた の 状況 分析 は 正確な ものである 。
I took care of my sick sister .	私 は 病気の 姉 を いたわった 。
The goods are exempt from taxes .	この 商品 は 免税品 です 。
This is the biggest issue in this matter .	それ は この 件 に 関する 最大の 問題点 です 。
He is an unpleasant fellow .	彼 は いやな やつ だ 。
She guided me to the palace .	彼女 は 宮殿 へ 案内 して くれた 。
We have just a tiny bit of garden .	うちの 庭 は 猫の額 ほど の 狭 さ なんです よ 。
The smart young woman passed the exam as a matter of course .	当然の事ながら 、 その 頭 の 良い 若い 女性 は 試験 に 受かった 。
I finished writing the letter by noon .	私 は 昼 まで に 手紙 を 書き 終えた 。
May I have a bus schedule ?	バス の 時刻表 を ください 。
She cared for her sick father .	彼女 は 病気の 父 の 世話をした 。
He is always finding fault with others .	彼 は いつも 他人 の あら捜し を している 。
His misspelling of that word eliminated him from the contest .	その 語 の 綴り を 間違って 、 彼 は コンテスト に 失格 した 。
It would be better for you not to ask him for advice .	君 は 彼 に 助言 を 求めない 方がいい だろう 。
Such a strange thing is not likely to happen .	そんな 不思議な 事 は 起こり そうもない 。
Prices will continue as they are .	物価 は 現状 の まま 続く だろう 。
The reason is because I can speak Chinese .	何故 ならば 、 私 は 中国語 が 話せます 。
Obviously , they are jealous of his wealth and status .	明らかに 、 彼ら は 彼の 富 と 地位 を 妬んでいる 。
Let him pay for it .	彼 に お 金 を 払わせれば ？
Japanese businessmen are calling for a level playing field .	日本 の ビジネスマン は 対等 の 場 を 要求 しています 。
He felt a resentment against his uncle for taking him in .	よくも 自分 を 欺いた な と おやじ に対して 憤り を 感じた 。
I could n't understand him at first .	私 は 最初 に 彼 の 言う こと が わからなかった 。
She was discouraged from publishing her first novel .	彼女 は 初めて の 小説 を 出版 する の を 思いとどまった 。
It seems that it is getting warmer and warmer every year .	毎年 だんだん 暖かく なって くる よう に 思われる 。
Normal sleep is made up of two phases .	通常の 睡眠 は ２つ の 段階 からなる 。
The company did n't make any effort to improve its business practices .	その 会社 は 事務所 改善 の 努力 を しなかった 。
However , it is good if one can speak English well .	英語 が うまく 話せたら いい のに 。
The Rhine runs between France and Germany .	ライン 川 は フランス と ドイツ の 間 を 流れている 。
This castle is more beautiful than that .	この 城 は あの 城 よりも  美しい 。
The teacher did n't mind explaining the problem again .	先生 は 問題 を 説明 し直す こと を 嫌がらなかった 。
Mr Smith has n't turned up yet though he promised to come .	スミス さん は 来る 事 を 約束 した けれども まだ 現れて は いない 。
So the pigeon can feel the magnetic field on its head , but it ca n't feel the Earth 's magnetic field .	だから ハト は 自分 の 頭 の 上 に ある 磁場 を 感じる ことができる が 地球の 磁場 を 感じる ことができない 。
They gave it to me .	彼ら は それ を 私 に 与えた 。
Moderate exercise will be of benefit to your health .	適度 の 運動 は あなた の 健康 の ためになる だろう 。
His sons are not properly brought up .	彼の 息子 たち は しつけ が 、 ちゃんと できていない 。
He is not himself today .	今日 は いつもの 彼 ではない 。
My wife is subject to moods .	妻 は 気分 に 支配 され やすい 。
I 'm fed up with her chatter .	彼女 は おしゃべり には あきあき していた 。
A good pair of glasses will help you to read .	よい 眼鏡 は 読書 の 助け になる 。
He is ashamed of his son 's conduct .	彼 は 自分 の 息子 の 行動 を 恥ずかしく 思います 。
He did n't give me anything to eat .	彼 は 私 に 食べ物 を 一切 くれなかった 。
Where is the garbage area ?	ゴミ置き場 は どこ ですか 。
Let me have a try at it .	私 に それ を やらせて みて ください 。
That 's absolute nonsense !	それ は 全く 馬鹿げた 話 だ 。
She heaped her plate with salad .	彼女 は サラダ を 山 のように 皿 を 取った 。
A good teacher must be patient with his pupils .	りっぱな 先生 は 生徒 に 忍耐 強く なければならない 。
I start tomorrow .	明日 たちます 。
He slept with the window open .	彼 は 窓 を 開けた まま で 寝た 。
Hold on for a while , please .	しばらく このまま お待ち  下さい 。
His opinion inclines towards the conservative .	彼の 意見 は 保守的 傾向 を 帯びている 。
Please keep me informed of whatever happens in my absence .	留守中 の 出来事 は すべて 私 に 知らせて おいて ください 。
Do you have any bleeding ?	出血 は あります か 。
Three people are still missing .	３人 が 依然 行方不明 です 。
The door yielded to a strong push .	ぐいと 押す と ドア は 開いた 。
The world still has not found peace .	世界 は まだ 平和 を 見出していない 。
She made a promise to write to me every week .	彼女 は 毎週 手紙 を 書く と 私 に 約束 した 。
At that time , my mother was younger than I am now .	そのころ 母 は 今 の 私 より 若かった 。
Danger . Keep out !	危険 、 立入り禁止 ！
I traveled at my own expense .	私費で 旅行 した 。
She goes to a girls ' high school .	彼女 は 女子高校 に 通っている 。
Fresh fruit is good for you .	新鮮な 果物 は 君の 体 に よい 。
The girl vanished like magic .	少女 は まるで 魔法 のように 消え失せた 。
They have a strange affinity for each other .	彼ら は 妙に おたがいに 気が合う 。
Children under three are admitted free of charge .	三 歳 未満 の 子供 は 入場 無料 。
He went into the water before me .	彼 が 私 より 先に 水中 に 入った 。
I watched a tennis match on TV .	私 は テレビ で テニス の 試合 を 見た 。
They felt their way in the dark .	彼ら は 手探り で 暗闇 を 歩いて 行った 。
New office buildings seem to be sprouting up all over the city .	新しい オフィス ・ ビル が 町中 に 急に 増えて きた ようだ 。
I do n't know what to think .	私 には 、 どう 考えた って わかりません わ 。
Mr Thomas is a very able teacher .	トーマス 先生 は とても 有名な 先生 です 。
He sits up till late at night .	彼 は 夜遅く まで 起きている 。
She cheered me up when I was feeling blue .	彼女 は 私 が ふさぎ込んでいる と 元気づけて くれた 。
Life is not all fun .	人生 いい こと ばかり ではない 。
He suffered an insult .	彼 は 甘んじて 屈辱 に 耐えた 。
She does Mickey Mouse very well .	彼女 は ミッキーマウス の 真似 が とても 上手 だ 。
My mother taught me how to make osechi .	母 が 私 に おせち の 作り方 を 教えて くれた 。
A secretarial post is open .	秘書 の 口 が 一つ 開いている 。
The top of this tree is level with the fence .	この 木 の てっぺん は 垣 と 同じ 高さ だ 。
I received a warm welcome .	私 は 心から の 歓迎 を 受けた 。
The brake is n't working well .	ブレーキ が よく きかない 。
Zurich is the second largest gold market in the world after London .	チューリッヒ は ロンドン に 次ぐ 世界 第二 位 の 金市場 である 。
I hope my mistake will escape his notice .	私の 誤り が 彼の 目に留まら なければ よい が 。
We should obey the rules .	私たち は 規制 に 従う べき だ 。
From the viewpoint of health , Tokyo is not such a good place to live .	健康 の 観点 から 見れば 、 東京 は 生活 する のに そんなに よい 場所 ではない 。
They sell candy , cookies and what not .	その 店 で は キャンデー や クッキー その 他 など を 買った 。
Perfect !	バッチリ ！
How many people do you think have an ear for music ?	何人 ぐらい 音楽 が わかる と 思います か 。
She works for a hospital .	彼女 は 病院 に つとめています 。
Nowadays more and more people prefer country life to city life .	今日 で は 都会 の 暮らし より 田舎 の 暮らし を 好む 人 が ますます 多く なっている 。
The symbol `` X '' usually stands for an unknown quantity in mathematics .	Ｘ 記号 は 数学 で は たいてい 未知数 を 表す 。
That was her chance to show what she could do .	そこ が 彼女の 腕 の 見せどころ だった 。
Please leave nothing behind .	御 忘れ物 なき よう お願いします 。
That is all I know about him .	彼 について 、 知っている の は それだけ です 。
His long speech bored us all .	彼の 長い スピーチ に みんな うんざり した 。
It 's true that the project is a difficult task , but Mr Hara will be able to bring it off .	なるほど その 計画 は 難しい 仕事 だ が 、 原 さん なら やってのける だろう 。
This area was first settled by the Dutch more than two hundred years ago .	この 地域 は ２００ 年 以上 前 に 最初 に オランダ 人 が 植民 した 。
I wrote off for an application form .	わたし は 手紙 で 願書 を 送る よう 決めた 。
Easy on the mustard .	マスタード は 少なめ に お願いします 。
In the absence of sufficient proof , the police could not indict him .	十分な 証拠 が 無くて 警察 は 彼 を 起訴 できなかった 。
The two sisters became more and more famous .	その 二人 の 姉妹 は ますます 有名 になった 。
The staircase leading to the rooftop is narrow , steep , and dark .	屋根 に いく 階段 は 狭くて 急 で くらい です 。
He is a good swimmer .	彼 は 泳ぎ が 上手 です 。
I was asked to put away all the papers we used at the meeting .	私たち が 会議 で 使用 した 書類 を すべて かたづける ように 頼まれた 。
Sports always come naturally to him .	どんな スポーツ でも 彼 には わけなく 出来る 。
You will learn to love your baby .	そのうち 赤ん坊 が 可愛く なる よ 。
There are grammatical principles involved .	文法 の 原則 が 含まれている 。
The news had a great impact on us .	その ニュース は 我々 に 大きな 衝撃 を 与えた 。
It 's impossible not to be fascinated by her beauty .	彼女の 美し さ に 魅了 されず に いる こと は 不可能 だ 。
I want to send this parcel at once .	この 小包 を すぐ 送り たい 。
You have been imposed upon .	君 は だまされている 。
How much is the fare on the bus ?	この バス の 料金 は いくら ですか 。
He rose from day laborer to governor .	彼 は 日雇い労働者 から 知事 に なりあがった 。
I 'll leave you to lock up .	あと 、 戸締り よろしく な 。
Who has leadership ?	誰 が リーダーシップ が ある の 。
Suppose it were true , what would you do ?	もし それ が 本当 なら 君 なら どうするか 。
This group passes out information on such things as travel and health care , and encourages its members to vote on issues that affect this age group such as legislation regulating the insurance industry , medical care and housing .	この 団体 は 、 旅行 や 健康管理 と いった こと に 関する 情報 を 配布 し 、 保険業 や 医療 や 住宅 （ 供給 ） を 規制 する 法律 の 制定 と いった 、 この 年齢層 の 人々 に 影響 の ある 諸問題 に関して 投票権 を 行使 する ように 会員 に 勧めている 。
When does school break up ?	学校 は いつ 休み になる のです か 。
Hills and fields cloaked in spring colors .	野山 は 春 の 装い だ 。
There 's nothing important in the paper .	新聞 には 大した こと は 何も 出ていない 。
The hotel charged me 8000 yen for the room .	ホテル は 部屋代 として 私 に ８０００ 円 請求 した 。
He made it known where the president had gone .	彼 は 社長 が どこ へ 行った か を 明らかにした 。
This game can be played by young children .	この ゲーム は 幼い 子供 にも できる 。
The new novel added greatly to his reputation .	今度 の 小説 は 彼の 名声 を さらに 大きく 高めた 。
I 'll finish it in one hour .	１時間 で 終わります 。
The mountain is covered with snow all the year round .	その 山 は 一年中 雪 で 覆われています 。
Do n't play around too much after school .	帰り道 で 道草 する ん じゃない の よ 。
It is yet to be seen whether this plan will succeed or not .	この 計画 が 成功 する かどうか まだ 分からない 。
He lived a happy life .	彼 は 幸福な 人生 を 送りました 。
How many hairs are there in a cat 's tail ?	猫 の しっぽ には 何 本 毛 が ある か 。
He could no longer stand the pain .	痛くて 我慢 し きれなく なった 。
3 to the third power is 27 .	３ の ３ 乗 は ２７ である 。
One of my cousins is married to a novelist .	私の いとこ の ひとり は 小説家 と 結婚している 。
George began to climb all unawares .	ジョージ は 何も 知らず に 階段 を のぼり 始めた 。
Every man has his own strong points .	人 は 誰でも 、 それぞれ の 長所 を 持っている 。
Do n't change your plans , whatever happens .	たとえ 何 が 起こって も 計画 を 変えて は いけません よ 。
The airplane is capable of supersonic speeds .	その 飛行機 は 超音速 で 飛ぶ ことができる 。
I ca n't smoke .	私 は タバコ が 吸えません 。
I need to get a stamp .	私 は 切手 を 手に入れる 必要 が ある 。
I insist that he should go with us .	彼 は 私たち と 一緒に いく べき です 。
What are you referring to by `` relationship '' ?	「 関係 」 という 言葉 で 何 を 言っている のです か 。
He earns 300,000 yen a month .	彼 は 月 に ３０ 万 円 稼ぐ 。
We spend piles of money on the things we do n't really use .	私達 は たくさん の 金 を 実際 には 使用 しない もの に 使う 。
To my amazement she came first .	彼女 が 最初 に 来た の には びっくり した 。
She caught my eye .	彼女 は 僕 の 目を引いた 。
Do n't take chances .	危ない 事 は する な 。
Tomorrow is convenient for me to call on you .	明日 あなた を 訪問 する の が 、 私 には 都合がよい 。
He 's a member of the golf club .	彼 は ゴルフクラブ の メンバー です 。
She changed her hairstyle during summer vacation .	彼女 は 夏休み の 間 に 髪型 を 変えた 。
Is n't it a mild winter this year ? Makes life easier .	今年 は 暖冬 ね 。 すごし やすくて いい や 。
Boeing has calculated the chances of a series of crew errors leading to CFIT .	ボーイング 社 は ＣＦＩＴ を 引き起こす 一連 の 乗務 員 の ミス の 可能性 を 推定 した 。
The dog has a keen scent .	この 犬 は 鋭い 臭覚 を もっている 。
Give me a break . If you have something to say , stop making faces and say it .	何 その 顔 ！ もう いい加減にして よ ！ 何か 文句 でもある の ？
She is eight months pregnant .	彼女 は 妊娠 ８ か月 だ 。
Much as I pitied him , I could not help him .	私 は 彼 を 非常に 哀れに 思った けれども 、 助ける ことができなかった 。
I 'm listening to the radio .	ラジオ を 聞いています 。
Hello , Tom .	こんにちは 、 トム 。
You may go at your leisure .	暇な 時 に 出かけ なさい 。
I 've finished reading the book .	その 本 を 読み 終えた 。
He pointed out that the plan would cost a lot of money .	彼 は その 計画 には 多額 の お金 が かかる だろう と いう こと を 指摘 した 。
We were just talking about you when you called .	君 が 電話 を くれた 時 私達 は ちょうど 君 の 事 を 話していた 。
Do it as soon as possible .	出来るだけ 早く それ を し なさい 。
He works few days a week , and gets little money .	彼 は 週 に 何日も 働かない し 、 収入 も ほとんど 無い 。
He was flying down the road .	すごい 勢い で 駆けて いった よ 。
I stood waiting for a bus .	私 は たって バス を 待っていました 。
Yumiko married a childhood friend last June .	ゆみこ は この前の ６月 に 、 子供時代 の 友人 と 結婚した 。
The policeman drove the crowd away .	警官 は 群集 を 追い払った 。
They welcomed her warmly .	彼ら は 彼女 を 暖かく 迎えた 。
Though the Browns have seven children , they seem to make ends meet .	ブラウン 家 には ７ 人 の 子供 が いる が どうにか やりくり している ようだ 。
What is she about ?	彼女 は 何 を やっている のだ ？
My job is teaching English .	私の 仕事 は 英語 の 先生 です 。
When I did n't know how to answer the question , he gave me a hint .	私 が 質問 に 答えられないでいる と 、 彼 が 助け舟 を 出して くれた 。
The geologists explored for oil on our farm .	地質 学者 が 私たち の 農場 で 石油 の 実地調査 を 行った 。
She was wearing long boots .	彼女 は ロングブーツ を 履いている 。
I 'll tell him so when he comes .	彼 が 来たら そう 伝えよう 。
We generally drink tea after a meal .	私たち は 一般に 食後 に お茶 を 飲む 。
It was nothing but the shadow of a tall tree .	それ は 高い 木 の 影法師 に すぎなかった 。
She laughed to cover her fear .	彼女 は 恐怖心 を 隠す ため 笑った 。
Do n't spare yourself in this work .	この 仕事 に 骨惜しみ を して は いけない 。
He cleared his throat before starting the lecture .	彼 は 講演 を 始める 前 に 咳払い を した 。
It ca n't be true .	それ は 本当 である はずがない 。
Every year , spring brings warm weather to our town .	毎年 、 私たち の 町 は 春 には 暖かい 天気 になる 。
The essence of Japanese culture could never be appreciated by them .	どうせ 日本 文化 の 粋 など は 連中 には 絶対 わかる まい 。
You are always digging at me about my clothes .	君 は 、 いつも 私の 服 を けなす の だから 。
Mom did n't mention it .	ママ は その 事 について は 触れなかった 。
I will part company with her .	私 は 彼女 と 別れる つもり だ 。
Her late husband was a pianist .	彼女の 亡夫 は ピアニスト であった 。
He is in good health in spite of his age .	年 にもかかわらず 彼 は 健康 だ 。
You really have a passion for food .	君 は 食べ物 に 目がない ね 。
It 's no laughing matter .	笑い事 じゃない よ 。
War has produced famine throughout history .	戦争 は 歴史上 ずっと 飢餓 を 引き起こして きた 。
The resignations would have little or no effect on upcoming indications .	辞任 劇 は 来る べき 徴兵 事務 には さして 影響 は ない であろう 。
He failed to catch the 8:30 train .	彼 は ８ 時 ３０ 分 の 電車 に 間に合わなかった 。
He watched the Sumo wrestling with folded arms .	彼 は 相撲 を 、 腕組 を して みつめていた 。
My mark for the English examination was close to the average mark of the class .	英語 の テスト の 点 は クラス の 平均 ぐらい だった 。
I bought a cat at that shop .	私 は あの 店 で 猫 を 買った 。
We love him all the more because he is honest .	私たち は 彼 が 誠実 だから なおさら 彼 が 好き です 。
The rule should be revised .	その 規則 は 修正 される べき だ 。
Beth is committed to Chris and eagerly accepted .	ベス は クリス に ぞっこん なので 、 喜んで それ を 引き受けました 。
Only members of the club are entitled to use this room .	クラブ の 会員 だけ が この 部屋 を 使用 する 資格 を 与えられている 。
You must do it by the end of this week .	今週 の 終わりまで に やらなくて は 、 いけません 。
If I were you , I would do the same .	私 が あなた だ としても 、 同じ こと を する だろう 。
It seems that the policeman in this TV series is a dirty cop who abuses his authority .	この テレビドラマ の 警官 は 職権 を 乱用 する 汚職警官 みたい です 。
He searched his bag for his car key .	彼 は 自動車 の キー を 見つけよう と 鞄 の 中 を 捜した 。
The damage was held to a minimum .	被害 は 最小限 に 食い止められた 。
I helped her hang the picture on the wall .	私 は 彼女 が 壁 に 絵 を かける の を 手伝った 。
He brought the art of painting to perfection .	彼 は 絵画 の 技法 を 完成 させた 。
Discussion resumed after a short interruption .	ちょっと 中断 した あとで 討議 が 再び 始まった 。
He has done with Susie .	彼 は スージー と 縁を切った 。
How many minutes shall I boil this frozen asparagus ?	この 冷凍 アスパラガス は 何分 ゆで ましょうか 。
Do n't say bad things about others .	他人 の 悪口 を 言う な 。
The girl flung her arms around him .	少女 は 彼 に 抱きついた 。
He 's a carbon copy of his father .	彼 は おやじ に そっくり だ 。
In my understanding , those two experiments do not have common factors .	私の 理解 で は その 二つ の 実験 には 共通の 因子 は ない 。
Could you let him out ?	外 に 出して やって くれません か 。
To look at him , you could n't help laughing .	彼 を 見る と 、 笑わ ないではいられない だろう 。
I tried to get it , but to no purpose .	私 は それ を 手に入れよう とした が 、 全く 無駄 だった 。
I have an itch in my pubic area .	局部 に かゆみ が あります 。
How did you come here ?	ここ に なんで 来た の ？
I was disappointed because you were n't at home .	君 が 留守 だった ので 、 がっかり した 。
The major result from recent investigations of Emmet 's theory has been that it can be applied to biochemistry as well .	エメット 理論 が 生化学 にも 適用 できる と いう こと か 、 最近の 研究 の 主要な 成果 である 。
I talked my boyfriend into buying me a ring .	ボーイフレンド を 説得 して 指輪 を 買って もらった 。
While the civil war went on , the country was in a state of anarchy .	内戦 中 その 国 は 無政府状態 だった 。
He enjoys considerable standing among his peers .	彼 は 同輩 に 相当 受けがよい 。
He made a bet with her .	彼 は 彼女 と 賭け を した 。
The minute I entered the room , they stopped talking .	その 部屋 に 入る やいなや 彼ら は 話 を やめた 。
When he was at the acme of his career , a scandal brought about his downfall .	彼 は その 経歴 の 絶頂 に あった 時 、 スキャンダル が 起こって 彼 を 没落 させた 。
Everybody made for the door at the signal .	合図 で 皆 が ドア の 方 へ 向かった 。
John is the cleverest of us all .	ジョン は 私たち の すべての 中 で 一番 利口 だ 。
There 's a lot of mess to clear up .	片付け なければならない たくさん の ゴミ が ある 。
She spoke as though nothing had happened .	彼女 は 何もなかった かのように 話した 。
His wife is worn out after looking after the children .	彼の 妻 は 子供たち の 世話をした 後 で 疲れ切っている 。
You had better take a little rest .	君 は 少し 休んだ ほうがよい 。
The USA is composed of 50 states .	アメリカ合衆国 は ５０ 州 から 構成 されている 。
I had to go to my office by bus because my car had engine trouble .	車 の 調子が悪かった ので 会社 へ バス で 行か なければならなかった 。
She got a new CD player yesterday .	彼女 は 昨日 新しい ＣＤプレーヤー を 手に入れた 。
I ca n't figure him out .	彼 が どんな 人物 か よく わからない 。
Obviously I agree that you should advance in life through your own efforts .	もちろん 私 は 自ら の 努力 で 出世 する べき だ と いう 考え に 賛成 です 。
I like such sports as boxing and hockey .	ボクシング や ホッケー の ような スポーツ は 好き です 。
Waiting for Kate , I saw Bob and Mary .	ケイト は 待っている 間 に ボブ と メアリー に あった 。
How long have you known her ?	彼女 と 知り合って から どれくらい になります か 。
The captain breathed new life into his tired crew .	船長 は 疲れている 乗組員 に 新たな 活力 を 吹き込んだ 。
I have doubts about the success of their plan .	彼らの 計画 が 成功 する かどうか 疑問 に 思っている 。
The train left the station and was soon lost in sight .	汽車 は 駅 を 離れて 、 まもなく 見えなく なった 。
He broke his promise , which was a big mistake .	彼 は 約束を破った が 、 それ は 大きな 誤り だった 。
He did his best to the last .	最後まで 彼 は 最善を尽くした 。
The fighter plane released its bombs .	その 戦闘機 は 爆弾 を 投下 した 。
He can not so much as write the alphabet .	彼 は アルファベット すら 書けない 。
It will clear up by and by .	まもなく 晴れる でしょう 。
I 'm not concerned with the plan .	私 は その 計画 には ノータッチ です 。
The late Mr Smith was a doctor .	なくなった スミス さん は 医者 でした 。
A dog runs after a cat , and the cat after a mouse .	犬 が 猫 を 追いかけ 、 猫 が ネズミ を 追いかける 。
Does someone here speak Japanese ?	日本語 を 話せる 人 は います か 。
John is a far better singer than the others .	ジョン は 他の 者 より はるかに 歌 が うまい 。
You 're wasting your time .	時間の無駄 です よ 。
I 'm glad to see such a beautiful animal .	私 は その 様な 美しい 動物 に 会えて 嬉しい 。
What do you like to do on Sundays ?	日曜日 は 何 を します か 。
How beautiful the rising sun is !	昇る 朝日 は 何と 美しい の だろう 。
We got dead drunk .	ベロベロ に 酔っぱらっ ちゃった 。
He gave us an essay to write during the vacation .	彼 は 私達 に 休み中 に 書く エッセイ の 宿題 を だした 。
She was left in the sun too long .	その 子 は あまりにも 長く 日光 に さらされた 。
Her cheeks were tinged with red by the warmth of fire .	火 の 暖気 で 彼女の ほお が 赤く 染まった 。
I have written to him once a month for almost twenty years .	私 は 彼 に ２０ 年間 月 に １度 手紙 を 書いて きました 。
Losing his wife drove him to steal .	彼 は 妻 を 失って 気が狂った 。
The idea is very attractive .	その 考え は とても 魅力的 だ 。
He does n't have any pets .	彼 は ペット を 飼っていない 。
She promised her mother to come home before nine without fail .	彼女 は ９ 時 前 には 必ず 帰る と 母親 に 約束 した 。
I held him by the collar .	私 は 彼 の えり を つかんだ 。
Jim is crazy about his girlfriend .	ジム は 彼 の ガールフレンド に 夢中 です 。
She is anything but a singer .	彼女 は 決して 歌手 など ではない 。
I forgot to bring my umbrella with me .	傘 を 持って くる の を 忘れました 。
She had bright black eyes .	彼女 は 輝く 黒い 目 を していた 。
Do n't take it seriously .	まじめに 取らないで 下さい 。
During the night the wind blew cold .	夜 の 間中 吹く 風 は 冷たかった 。
I 'm off beer .	ビール を 飲む の は やめている 。
It is up to you to apply for the job .	その 仕事に応募する か しない か は 、 あなた が 決める こと です 。
The exact time is three now .	正確に いう と 今 は ３ 時 です 。
Are you quite satisfied with your new house ?	新居 に 満足 しています か 。
I do n't know .	知らない 。
Spring will be here before long .	春 は まもなく やってくる 。
He asked her to stay , but she did n't want to .	彼 は 彼女 に いて くれ と 頼んだ が 、 彼女 は い たくなかった 。
People who are afraid of making mistakes will make no progress in English conversation .	間違い を 恐れる ような 人 は 英会話 は 上達 しない だろう 。
He was so adamant in his refusal .	彼 は 断固 として 拒絶 した 。
These shoes will stand up to hard use .	この 靴 は どんなに 乱暴に はいて も 大丈夫 です 。
He studied hard in his youth , and it contributed to his success in later years .	彼 は 若い頃 一生懸命 に 勉強した 。 そして 、 それ が 彼の 後年 の 成功 に 貢献 した 。
Do n't tell tales out of school .	学校 の 中 の 話 を 外 で する な 。
The boy was almost drowned .	その 少年 は おぼれ そうになった 。
Is this your favorite song ?	これ は あなた の お気に入り の 曲 ですか 。
John was tired from working overtime .	ジョン は 残業 で 疲れていた 。
The gate was left open .	出入り口 は 開けた まま になっていた 。
Mr Miura brought an action of libel against a weekly magazine .	三浦 氏 は ある 週刊誌 に対して 名誉毀損 の 訴え を 起こした 。
I hurried to the bus stop so that I would not miss the last bus .	最終 バス に 乗り遅れない よう 、 バス停 に 急いだ 。
Of the two stories , the latter story is better .	２つ の 物語 の うち 、 後の 方が良い 。
In Japan people come of age when they are 20 years old .	日本 で は 、 ２０歳 で 成人 となる 。
The Tigers lost the game , which was a surprise to us .	タイガース は その ゲーム に 負けた 。 それ は 私達 には 驚き だった 。
He likes to work in the garden .	彼 は 庭 で 仕事 を する こと が 好き だ 。
This , the first of the miraculous signs , Jesus performed in Cana in Galilee .	イエス は この こと を 最初の しるし として ガリラヤ の カナ で 行った 。
Come to think of it , I promised to see him at five .	考えて みる と 、 私 は ５ 時 に 彼 に 会う約束 が あった 。
Rick was over the moon about passing the exam .	リック は 試験 に 合格 して 有頂天 だった 。
Just follow your heart .	自分 の 思う とおり に し なさい 。
He made his fortune from commerce .	彼 は 貿易 で 財産 を 築いた 。
I think I 'll go in for tennis .	テニス に 首をつっこんで みよう か 。
His salary is double what it was seven years ago .	彼の 給料 は ７ 年 前 の ２倍 です 。
Man is a creature of circumstances .	人間 は 環境 の 動物 である 。
You have changed quite a lot .	あなた は ずいぶん 変わりました ね 。
The chickens were scratching for food on the ground .	ヒヨコ が えさ を 探して 地面 を つついている 。
Gravity pulls things toward the center of the earth .	重力 が 物 を 地球の 中心 に 引っ張っている 。
The machine operates all day long .	その 機械 は 一日中 作動 しています 。
Do Japanese children really paint the sun red ?	本当に 日本 の 子供たち は 太陽 を 赤く ぬる のです か 。
There 's not so much text in this book .	この 本 は 本文 の 部分 は そんなに 多くない 。
Well , you ca n't .	まあ 無理 です な 。
As food and drink is to animals , so are rain and sunshine to plants .	動物 に 食物 と 飲み物 が 大切な ように 、 植物 には 雨 と 日光 が 大切 である 。
He was born at seven on the morning of June 5 in 1970 .	彼 は １９７０ 年 ６月 ５日 の 朝 ７ 時 に 生まれた 。
He picked up the newspaper and glanced casually over the front page .	彼 は 新聞 を 取り上げて 何気なく １面 を 眺めた 。
This is her T-shirt . That T-shirt is hers , too .	これ は 彼女の Ｔシャツ だ 。 あの Ｔシャツ も 彼女の もの だ 。
It scared the daylights out of him .	彼 は びっくり して 肝を冷やした 。
This suite is three times larger than my condominium .	この スイートルーム は 私の 住んでいる マンション の 三倍 の 広 さ だ 。
Father manages the store .	父 は その 店 を 経営 している 。
It cost me a lot of money to build a new house .	私 が 新しい 家を建てる のに たくさん 費用 が かかった 。
Of those 2 or 3 were pushed out of the nest , and then fell down from the balcony as well .	その うち の ２ 、 ３ 羽 が 巣 から 押し出され 、 さらに ベランダ から も 落ちて しまった 。
There is no life on the moon .	月 に 生物 は いない 。
Let me introduce myself .	自己紹介 を させていただきます 。
`` Look - there 's a fire !! '' Exclaimed Dan .	「 見ろ 、 火事 だ 」 と ダン が 叫んだ 。
I lost a ten-dollar note .	私 は １０ ドル 紙幣 を なくした 。
Let 's hurry up .	急ぎましょう 。
You got the date wrong when you were filling in the check .	あなた は 小切手 に 書き込む 時 に 、 日付 を 間違えた 。
He says nobody cares for a thing like that .	そんな もの を 好む もの は いない 、 と 彼 は 言っている 。
He went off without saying good-bye .	彼 は さよなら も いわないで 立ち去った 。
Doctors have made great strides in their fight against cancer .	医師 達 は 癌 と の 戦い で 大 躍進 を 遂げた 。
At today 's meeting almost everybody backed my plan .	今日 の 会議 で 殆ど みんな が 私の 案 を 支持 して くれた 。
You had better not repeat such an error .	君 は そんな 間違い を くり返さない 方がよい 。
What you said does not apply to this case .	あなた の 言った こと は この場合 当てはまらない 。
He has more books than he can read .	彼 は 読み切れない ほど たくさん 本 を 持っている 。
I took a bath and then had a glass of beer .	私 は 風呂 に 入り 、 それから ビール を 一杯 飲んだ 。
The light went out and we were left in the dark .	明かり が 消えて 、 私たち は 闇の 中 に 取り残された 。
I dare not speak to her .	私 は 思い切って 彼女 に 話しかける ことができない 。
Although it is a very difficult task , I will do my best .	たいへん 困難な 仕事 だ けれども 、 私 は 最善を尽くします 。
If the brain is dead , we should let the patient die .	もしも 脳 が 死んでいたら 、 その 患者 を 死なせて あげる べき です 。
I can ride a bicycle .	私 は 自転車 に 乗る ことが出来る 。
I hope that Japan will abide by Article 9 of her Constitution .	私 は 日本 が 憲法 第 ９ 条 を 守る こと を 希望 します 。
My contemporaries are , working , shopping , out and about , all the time .	同 世代 の 人 は 、 仕事 とか 、 買い物 で 留守 ばかり です 。
I took the children to school .	子供たち を 学校 に 連れて行った 。
The hotel is down there .	その ホテル なら そこ です よ 。
This information is confidential .	この 情報 は 秘密 です 。
It is not difficult to speak English .	英語 を 話す の は 難しくない 。
This telephone is out of order .	この 電話 は 故障 している 。
How does the preface run ?	序文 には なんと 書いてあります か 。
The roof is really in need of repair .	屋根 を ぜひ 修理 する 必要 が ある 。
A man is responsible for his deeds .	人 は 自分 の 行為 に対して 責任 が ある 。
Come , Jesus replied .	「 来 なさい 」 イエス は 言われた 。
Put down your pencil .	鉛筆 を 置き なさい 。
Little did she dream that she could win first prize .	１等 を とれる なんて 彼女 は 夢にも 思わなかった 。
Can you see a sail on the horizon ?	水平線 に 船 の 帆 が 見えます か 。
She is good at speaking English .	彼女 は 英会話 が 得意 だ 。
I am busy preparing for the next exam .	私 は 次の 試験 の 準備 で 忙しい 。
Each episode of that TV drama ends with somebody delivering a profound line .	あの ドラマ 、 最後 に いつも 意味深な 言葉 を 言って 終わる よ ね 。
She smokes 20 cigarettes a day .	彼女 は １日 に ２０ 本 煙草を吸う 。
See you a little past 7 .	７ 時 過ぎ に ね 。
He had really come to get gold .	彼 は 本当 金 を 手に入れる ために やって来た の であった 。
Please inform me of any changes in the situation .	どんな 状況 の 変化 にも 私 に 知らせて ください 。
In fact , I 'll even call George at the office and tell him he ought to come home and help out .	何 なら ジョージ の 職場 に 電話 を して 、 すぐ 帰宅 して お前 を 手伝う ように と 伝えよう かい 。
One after another they stood up and went out .	つぎつぎに 立って 出ていった 。
I 'm adamant that you should go .	君 に 行って もらわねば 承知 しない 。
Would you mind coming with me ?	私 と 共に 来て くれません か 。
He is tired , and so am I.	彼 は 疲れている し 、 私 も 疲れている 。
Here is the book you are looking for .	ここ に 君の 探している 本 が ある 。
He walked on tiptoe so that nobody would hear him .	誰にも 聞かれない ように 彼 は つま先 で そっと 歩いた 。
I am as happy as can be .	私 は 最高に 幸せ だ 。
Everyone seems to have a bone to pick with someone , but only a few people can be philosophical about it .	だれにも 不満 の 種 は ある 。 だ が 、 それ を 達観 できる の は 、 ごく 少数 の 人 だけ だ 。
Do n't make the same mistake again .	おなじ 間違い を 繰り返す な 。
He holds great influence with the Association of Medical Sciences .	彼 は 医学会 に 多大な 影響力 を 持っている 。
Do you mean to do without an overcoat ?	あなた は オーバー なしですます つもり ですか 。
I was late on account of an accident .	私 は 事故 の ために 遅れた 。
No blame attaches to his conduct .	彼の 行為 には なんら 非難 すべき ところ が ない 。
As the baby was born , the Tanaka had to hire a part-timer .	赤ちゃん が 生まれた ので 、 田中 さん 一家 は パートタイマー を 雇わ なければならなく なった 。
Say hello to your sister for me .	妹さん に よろしく ね 。
I do n't know how to use an art file -LRB- .	アート ファイル (.art) の 使用法 が わかりません 。
It was heroic of them to oppose the enemy .	彼等 が 敵 に 向かう とは あっぱれ であった 。
You must help her , and soon !	君 は 彼女 を 助け なければいけない 。 しかも すぐに 。
At that store , they deal in fish and meat .	あの 店 で は 、 魚 と 肉 を 売っている 。
The revolution has brought about many changes .	革命 によって 多く の 変化 が 起こった 。
The old man wondered why life had passed him by .	老人 は 人生 が いたずらに 過ぎて しまった の は なぜ だった の か と 考えた 。
The girl was busy making tea for her friend .	少女 は 友達 に お茶 を いれる のに 忙しかった 。
I have the right to call my lawyer .	私 には 、 弁護士 に 電話 を する 権利 が あります よ 。
His wife comes from California .	彼の 妻 は カリフォルニア の 出身 だ 。
That horse came in first place .	その 馬 は 一着 になった 。
Society has seen a lot of change recently .	最近 社会 に 多く の 変化 が あった 。
He never shrinks from danger .	彼 は 危険 を ものともしない 。
My brother is engaged in cancer research .	兄 は ガン の 研究 に 従事 している 。
He is an authority on the humanities .	彼 は 人 文学 の 権威 だ 。
All those flowers look alike .	これらの 花 は みな 同じように みえます 。
I have to attain my purpose at all costs .	私 は 是非とも 目的 を 達成 せねばならない 。
It is you that is to blame for it .	それ について は あなた に 責任 が あります 。
Would you meet with us at a time that is convenient for you ?	ご 都合のよい とき に 、 私ども お会い できません か 。
Can a child do such a cruel thing ?	いったい 子供 が そんな 残酷な こと を する だろうか 。
In those days I tended to think of myself as a nice looking guy .	当時 私 は 自分 を 美男子 だ と 思う 傾向 が あった 。
Africa is a continent , but Greenland is not .	アフリカ は 大陸 である が 、 グリーンランド は 違う 。
He got the first prize in a 100m race .	彼 は １００ｍ 競争 で 一等賞 を 受け取った 。
Last call !	ラスト ・ オーダー は 締め切らせて いただきました 。
I shall never forget your kindness .	ご 親切 は 決して 忘れません 。
His face radiated enthusiasm .	彼の 顔 は 情熱 の 光を放っていた 。
I would appreciate it if I had the opportunity to meet with Mr Brown again during his stay in Chicago .	ブラウン 様 が シカゴ に いらっしゃる 間 に もう一度 お会い できたら 、 うれしい のです が 。
Some of the roses in my garden are white , and the others are red .	庭 の ばら の いくつか は 白 だ が 、 残り は 全部 赤 です 。
The exam is coming up next week .	来週 試験 だ 。
The town was defended by a large army .	街 は 大軍 によって 守られた 。
Doctors suspect smoking has lot to do with cancer .	医者 は 喫煙 は 癌 と きわめて 関係 が ある と おもっている 。
We were driven to the wall .	我々 は 絶体絶命 の ピンチ に 追い込まれた 。
This dictionary contains not less than fifty thousand words .	この 辞書 には 少なくとも ５ 万 語 載っている 。
They did not oppose the project just because they feared public opinion .	彼ら は 世論 が 怖い からといって その 計画 に 反対 した の ではない 。
His mother died when he was young , and his grandmother brought him up .	彼の 母親 は 彼 が 小さい とき に 亡くなった ので 、 お祖母さん が 彼 を 育てた 。
How are your studies going ?	あなた の ご 研究 は 、 いかが ですか 。
I have gone astray somewhere in my calculations .	ぼく は 計算 の どこか で 間違って しまった 。
It matters little what kind of books one reads , so long as one has sound judgement .	しっかり した 判断力 が あり さえすれば 、 どんな 種類 の 本 を 読もう と たいした 問題 ではない 。
He is , at bottom , an honest man .	彼 は 根 は 正直な 人間 である 。
I do n't feel like eating at all this summer .	今年 の 夏 は 全く 食欲 が ない 。
The apple is not yet ripe .	その 林檎 は まだ 熟していない 。
Take care .	お 気をつけて 。
Shake off the towels .	タオル の ほこり を 払い なさい 。
You can hardly expect me to help you .	力を貸す こと は 、 ほとんど 出来ない と 思って ください 。
They found the stolen money .	彼ら は 盗まれた お金 を 見つけた 。
He was a great statesman and was elected president .	彼 は 偉大な 政治家 であった 、 そこで 大統領 に 選ばれた 。
Please review the contents and provide any appropriate feedback .	内容 を ご覧になり 、 適切な ご 意見 を いただければ 幸い です 。
I do not desert .	僕 は 見捨てない 。
Turning right , you 'll find the hospital on your left .	右 に 曲がる と 、 左手 に 病院 が あります 。
They are muddy .	どろ で 汚れている 。
He is as young a teacher as ever taught here .	彼 は ここ で 教えた 先生 の 中 で 一番 若い 先生 です 。
Where is the bus stop for the museum ?	美術館 行き の バス 停留所 は 、 どこ ですか 。
It is not easy to write in chalk .	チョーク で 書く の は やさしい こと ではない 。
I intend to take my position as a third party .	わたし は 第 ３ の 立場 を 取る つもり だ 。
They say that he was ambitious when young .	彼 は 若いころ 野心家 だった そうだ 。
I believe him honest .	私 は 彼 を 正直 だ と 信じています 。
I ca n't afford to buy a car .	私 は とても 車 など は 買えない 。
She engaged him as a programmer .	彼女 は 彼 を プログラマー として 雇った 。
His illness resulted from drinking too much .	彼の 病気 は 飲み すぎ から 起こった 。
She smiled her acknowledgment .	彼女 は にっこり 笑って 感謝 の 気持ち を 表した 。
It 's the best job in the world !	世界 で いちばん いい 仕事 だ もの ね 。
He looks a bit tired , does n't he ?	彼 は 少し 疲れている よう です ね 。
You should notify the police at once .	すぐ 警察 に 通報 して ください 。
Trains rattled overhead .	頭上 で 電車 が ガタガタ 音を立てていた 。
The pickled radish needs a touch of salt .	この 沢庵 は 塩気 が 足りない 。
The work will be finished at six .	その 仕事 は ６ 時 に 済みます 。
The story was too pat and I got rather suspicious .	話 が 合い すぎる ので 、 かえって 何か 怪しい と 思った 。
The matter should be tried in public .	その 問題 は 公にして さばかれる べき だ 。
I find interest in the social page in that newspaper .	私 は あの 新聞 の 社会面 に 興味 が あります 。
Did you turn off the gas ?	ガス を 消しました か 。
I fix the terms .	条件 を 決める 。
Mr. Sato collapsed from exhaustion .	佐藤 さん は 疲れ切って 倒れた 。
Seen from the plane , the islands were very pretty .	飛行機 から 見る と 、 その 島々 は とても きれい だった 。
He finished the work at the expense of his health .	彼 は 健康 を 犠牲 に して その 仕事 を 終えた 。
His trip will keep him away from the office for a week .	旅行 の ため 、 彼 は 一週間 休みます 。
I am sorry to cancel the appointment at the last minute .	土壇場 になって 約束 を キャンセル し 、 申し訳ありません 。
The old man sat down .	その 老人 は 腰をおろした 。
Many beautiful flowers bloom in spring .	たくさん の 美しい 花 が 春 に 咲く 。
The Prime Minister stated that he would not introduce a new tax without the consensus of public opinion .	首相 は 国民 の 合意 が なければ 新税 は 導入 しない と 言明 した 。
English is spoken around the world .	英語 は 世界中 で 話されている 。
She lived a happy life .	彼女 は 幸せ に 暮らした 。
I have no one to help me .	私 を 助けて くれる 人 は 誰も いない 。
She went to the door to welcome her friends .	彼女 は 友人 を 迎える 為に 玄関 へ 行った 。
It is no use arguing about it .	それ について 議論 して も むだ だ 。
Many students are looking for part-time jobs .	多く の 学生 が アルバイト を 探しています 。
This is my dog .	あれ は 私の 犬 です 。
Which is mine ?	どちら が 私の もの ですか 。
Students discussed the problem of brain death for a long time .	学生 たち は 脳死 の 問題 について 長々と 議論 した 。
When he writes , he always keeps a dictionary at hand .	彼 は 書きもの を する 時 には 、 いつも 辞書 を 手元 に 置いている 。
I have a few friends in Tokyo .	私 は 東京 に 数人 の 友人 が いる 。
You must pay in advance .	前もって お 金 を 払って お か なければなりません 。
The street is named for President Madison .	その通り には マジソン 大統領 の 名 が 付けられている 。
Cheer him up when you see him .	あなた は 彼 に 会ったら 元気づけて やり なさい 。
She managed to learn to drive a car .	何とか 彼女 は 車 を 運転 できるようになった 。
`` Would you mind opening the window ? '' `` Certainly not . ''	「 窓 を 開けて くださいます か 」 「 ええ 、 いい です よ 」
What 's your major field ?	君の 専攻 分野 は 何 ですか 。
The dog had a piece of meat in its mouth .	その 犬 は 肉 を 一切れ   くわえていた 。
It was so hot in the stadium that I thought I was going to pass out .	スタディアム は たいへん 暑くて 、 倒れる か と おもった 。
She drank a cup of milk .	彼女 は ミルク を １杯 飲んだ 。
Man is born a sinner .	人間 は 生来 罪人 である 。
Practice makes perfect .	練習 が 完ぺき （ な 腕まえ ） に する 。
My brother is as tall as me .	私の 弟 は 私 と 同じくらい の 背 です 。
We go fishing together once in a while .	私たち は 時折 釣り に 行く 。
It 's quite natural for him to think so .	彼 が そう 考える の は 全く 当然 だ 。
You know how crazy they are over their little bundle of joy .	彼ら が 孫 に どんなに 夢中 か 知っている でしょ 。
Let 's not talk about it any more .	もう その 話 は やめましょう 。
I checked the time on the clock .	私 は 時計 で 時刻 を 確かめた 。
This year there were few rainy days in August .	今年 の ８月 は 雨 が ほとんど 降らなかった 。
They are going off by plane tomorrow .	彼ら は 明日 飛行機 で 行って しまう 。
She has lost weight .	彼女 は 体重 が 減って きた 。
Please be careful of your health .	どうぞ 健康に 注意 して ください 。
It is jelly that he likes .	彼 の 好きな の は ゼリー です 。
To see her smile , you would be charmed .	彼女の 微笑 を 見れば 、 君 は 魅了 される だろうに 。
You lied to me , did n't you ?	君 は 私 に 嘘をついた ね 。
Like knows like .	英雄  は英雄を知る 。
I paid 800 yen for this book .	私 は この 本 に 八 百 円 を 払った 。
The trees kept me out of the rain .	木 の おかげで 雨 に ぬれず に すんだ 。
You can not be too polite when you meet the president .	会長 に 会う 際 には どんなに 丁寧 にしても しすぎる こと は ない 。
He is given to drink .	彼 は 酒 に ふけっている 。
He ordered me to go alone .	彼 は 私 に １人 で 行け と 命じた 。
It hurts terribly .	ひどく 痛む 。
Were the sun to rise in the west , she would not change her resolution .	たとえ 、 太陽 が 西 から 昇った としても 、 彼女 は 決心 を 変えない だろう 。
This magazine circulates widely .	この 雑誌 は 広く 行き渡っている 。
It is better to read a few books carefully than to read many at random .	手当たり次第 に 多く の 本 を 読む よりも  、 少数 の 本 を 精読 する 方がよい 。
What a miser you are !	なんという けちん坊 だ 、 君 は 。
You have done a wonderful job .	素敵な 仕上がり だ わ 。
He defies the present government which is no less oppressive than its predecessor .	彼 は 、 前 の 政府 に劣らず 圧制的な 現 政府 に 公然と 反抗 している 。
Can I change the date of return ?	返却 日 を 変更 できます か 。
It 's now or never .	今 しか ない 。
I play the guitar in my spare time .	趣味 は ギター を 弾く こと です 。
Take either of the apples .	その リンゴ の どちらか を 取り なさい 。
I met him while I was staying in Paris .	パリ に 滞在中 、 私 は 彼 に あった 。
She is far from a fool .	彼女 は 愚か者 どころではない 。
Their trip was postponed because of the rain .	彼らの 旅行 は 雨 の ために 延期 された 。
He cut down a cherry tree .	彼 は 桜 の 木 を 切り倒した 。
The project to build a new sports center has fallen through for lack of adequate funds .	新しい スポーツ 施設 の 建設 計画 は 、 十分な 資金 が 無い ため 、 だめ になった 。
My father likes strong coffee .	父 は 濃い コーヒー が 好き です 。
The song descended from a legend .	その 歌 は 伝説 に 由来 する 物 だった 。
It 's all right to drink , but drink in moderation .	酒 も いい が 大概にして おきなさい 。
Please keep it secret .	どうぞ 秘密 を 守って 下さい 。
The government of that country oppresses its people .	その 国 の 政府 は 国民 を 圧迫 している 。
According to his advice , I decided it .	彼の 忠告に従って 、 私 は それ を 決断 した 。
He cut a fine figure in company .	彼 は 人 なか で 立派 に みえた 。
At the time there were no native English speakers teaching in any public school .	その 当時 、 どこ の 公立 の 学校 にも ネイティブ の 英語 の 先生 など いません でした 。
He approached her in the disguise of a policewoman .	彼 は 婦人警官 の 扮装 を して 彼女 に 近づいた 。
Which way did you choose ?	あなた は どちら の 道 を 選びました か 。
Every word in this dictionary is important .	この 辞書 の 全ての 単語 が 重要 です 。
I prefer silver rings to gold ones .	金 より 銀 の 指輪 の 方 が 好き です 。
You will play into their hands .	向こう の 思う壷 だ ぞ 。
He awoke to find the house on fire .	彼 は 目を覚まし 、 家 が 燃えている こと に 気づいた 。
We have known each other since childhood .	子供のころ から の 知り合い です 。
Much as I like you , I will not marry you .	私 は あなた が 好き だ が 、 結婚する 気 は ありません 。
One out of three persons in this city has his own car .	この 町 の ３人 に １人 が 自分 の 車 を 持っている 。
There were two women on board .	２人 の 女性 が 乗船 していた 。
She drew out the money from the bank .	彼女 は 銀行 から お金 を 引き出した 。
This word was borrowed from French .	この 語 は フランス語 から 借用 した もの だ 。
I hesitated to go to the movie with him .	彼 と 映画 に 行く の を ためらった 。
Keep the paper in the inside pocket .	書類 は 内ポケット に しまって おけ 。
If we do n't obtain an adequate knowledge of their culture , a lot of problems could easily arise .	他の 文化 について 十分な 知識 を 持ってい なければ 、 色々な 問題 が 容易に 起こりうる 。
They were never to meet again .	彼ら は 二度と 会えない 運命 に あった 。
He put the plan into practice .	彼 は その 計画を実行した 。
I 'm bad at singing karaoke .	私 は カラオケ が 苦手 です 。
Even disaster is better than such a divorce between emotion and action .	そのような 情緒 と 行動 の 分離 に 比べれば 、 破局 的 結果 の 方 が まだ まし である 。
He 's possessed by a strange idea .	奇妙な 考え に 取り付かれている 。
Taro bought a used car last week .	太郎 は 先週 中古車 を 買った 。
A man of reason could answer the question .	理性的な 人 なら その 質問 に 答えられる 。
I spoke to the principal himself .	私 は 校長 先生 に 直接 話 を しました 。
If you take 3 from 8 , 5 remains .	８ から ３ を ひく と ５ が 残る 。
Are sandwiches OK for lunch ?	お昼 は サンドイッチ で いい ですか 。
How many days a week do you go to school ?	一週間 の うち で 何日 学校 に 通います か 。
Today 's Tigers-Giants baseball game was called off due to heavy rain .	大雨 の ために 本日 の 阪神 ・ 巨人 戦 は 中止 になった 。
He took something out of his pocket .	彼 は ポケット から 何か を 取り出した 。
I ca n't stand being laughed at in front of others .	私 は 他人 の 前 で 嘲笑 される のに 耐えられない 。
The color white is a symbol of purity .	白 は 純潔 の 象徴 である 。
You need not have such fear .	あなた は そんなに 怖がる 必要 は ない 。
Sometimes water becomes a precious commodity .	水 も 高価な 商品 になる ことがある 。
He asked me if I had found it .	彼 は 私 が それ を 見つけた かどうか 聞いた 。
I 've made up my mind to come up with a better solution .	私 は もっと 良い 解決策 を 提案 する と 決心 した 。
As far as I know , they always keep their word .	私の 知る限り で は 、 彼ら は いつも 約束を守る 。
Of all the principles he once stood fast on .	数々 の 主張 から とった 痛み の ない エキス 。
I shall see him in less than a week .	一週間 たた ないうちに 彼 に 会う だろう 。
What on earth are you doing here ?	一体全体 ここ で 何 を している ん だい 。
Please accept this little gift .	つまらないものですが ご笑納 ください 。
She felt her heart beating fast .	彼女 は 心臓 が 激しく 鼓動 している の を 感じた 。
This is an important letter .	これ は 大切な 手紙 だ 。
Never speak ill of others .	他人 の かげ で 悪口を言って は なりません 。
Parents are responsible for their children 's education .	両親 は 子ども の 教育 に対して 責任 が ある 。
Then the younger brother set off , and the elder remained behind .	それで 、 弟 は 出発した 。 兄 は そのまま 残った 。
We tried to persuade Jim to join us .	ジム を 説得 して 仲間 に 加わらせよう とした 。
In a situation like this , there is nothing for it but to give in .	こういう 場合 には 妥協 する より ほか し方がない 。
Jim was so tired that he lay down and slept .	ジム は とても 疲れていた ので 横になって 眠った 。
Do you get along with your boss ?	あなた は 上司 と うまくやっていけています か 。
I 'm the leader of this team .	私 は この チーム の リーダー である 。
The human brain can adapt to new situations .	人間 の 脳 は 新しい 状況 に 適応 する ことが出来る 。
Stop inhaling your food . You should eat a little slower .	そんな ガツガツ 食べないで 、 もうちょっと ゆっくり 食べよう よ 。
They invaded the country .	彼ら は その 国 を 侵略 した 。
I do n't feel like talking with anyone .	誰 と も 話 を したくない のだ 。
I 'd like to check in .	手続き を したい のです が 。
She acted as leader of our club .	彼女 は クラブ の 指導者 を つとめた 。
I lost my shoe in the fire .	火事 の さなか に 靴 を 片一方 なくして しまいました 。
He is doing well in his college work .	彼 は 大学 の 学業 を りっぱ に やっている 。
The girl released the birds from the cage .	その 女の子 は 鳥 を かご から 逃がして やった 。
There is nothing special interest to me .	この 手紙 には 何も 特別 の こと が 書いていない 。
It 's going to rain .	たぶん 雨 になる だろう 。
She brushed her husband 's hat .	彼女 は 夫 の 帽子 に ブラシ を かけた 。
She found pleasure in reading .	彼女 は 読書 に 楽しみ を 見いだした 。
My Chinese did not pass .	私の 中国語 は 通じなかった 。
My father is proud of being tall and handsome .	父 は 背が高くて ハンサム な の を 自慢 している 。
It never occurred to me that he was the right man in the right place .	彼 こそ 適材適所 である こと が 私の 頭に浮かばなかった 。
Sleep is better than medicine .	睡眠 は 薬 に 勝る 。
I think little of his novel .	私 は 彼の 小説 を つまらない と 思う 。
You may be free to do what you like .	ここ で は 自由に 振る舞って いい です よ 。
Burn with desire .	愛情 に 燃える 。
It 's a miracle he was n't killed in the plane crash .	彼 が 飛行機 事故 で 助かった の は 奇跡 だ 。
She lives in Yokohama .	彼女 は 横浜 に 住んでいる 。
Why have you bought the same camera as I have ?	どうして 私の と 同じ カメラ を 買った のです か 。
He is as tall as his father .	彼 は 彼の お父さん と 同じ ぐらい の 背の高 さ である 。
You can go home now .	もう 帰宅 して も よろしい 。
`` Really ? '' `` Yes , really . ''	「 本当 ？ 」 「 はい 、 本当 です 。 」
I sold the house to advantage .	私 は 家 を 有利に 売った 。
He 's a carbon copy of his father .	彼 は 親父  と そっくり だ 。
Take a mean position in everything .	何事 にも 中道 的な 立場 を 取れ 。
He did not speak unless spoken to .	彼 は 話しかけられない と しゃべらなかった 。
The sum of all the angles in a triangle equals 180 degrees .	３角形の すべての 角 の 和 は １８０ 度 に 等しい 。
My opinion is entirely different from yours .	僕 の 意見 は あなた の と 全く 違います 。
Tell me about your daily life .	君の 日常生活 について 話して ください 。
The crowd yelled when he scored a goal .	彼 が 得点 を 挙げる と 群集 は 大声 を 上げた 。
Your car handles easily .	あなた の 車 は 運転 し やすい 。
I found her graceful .	彼女 は 優雅な 人 だ と わかった 。
It 's awfully hot today .	今日 は いやに 暑い 。
He has coached us for half a year .	彼 は 私たち を 半 年間 コーチ して くれた 。
Hand in your examination papers .	答案 を 提出 し なさい 。
He is a fish dealer .	彼 は 魚屋 です 。
Here is a true Israelite , in whom there is nothing false .	これ こそ 、 本当 の イスラエル 人 だ 。 彼 の 内 には 偽り が ない 。
I have a lot to think about in relation to the affair .	私 は その 件 について 考え たい こと が たくさん あります 。
He is to start tomorrow .	彼 は 明日 出発する 予定 だ 。
m. He was in time for the last bus .	彼 は 最終 の バス に 間に合った 。
I am to meet him at five at the station .	５ 時 に 駅 で 会う ことになっている 。
My baby began crying , asking for milk .	赤ちゃん が ミルク を 欲しがって 泣き出した 。
This man is very , very old .	この 男 は 非常に 年をとっています 。
Woman in a wheelchair holes up in supermarket .	車椅子 の 女性 、 スーパー に 立てこもる 。
It 's necessary to make his language like other people 's .	自分 の 言語 を 他の 人たち の 言語 と同じように する ために 必要な 変更 を 加える 。
I have a feeling that Masao may blow in sometime soon .	正夫 が 近いうちに ひょっこり 訪ねて くる かもしれない 気がする 。
A tongue is the most venomous thing of all .	舌 の 毒 に まさる 毒 は ない 。
My parents were born in Aichi Prefecture .	私の 両親 は 愛知県 で 生まれた 。
I was compelled to sign the paper .	私 は 、 無理に その 用紙 に 署名 させられた 。
His business is doing well .	彼の 商売 は うまくいっている 。
Every reporter sent his stories with the least possible delay .	どの 記者 も 、 自分 の 書いた 記事 を ただちに 送信 した 。
Our teacher showed us different kinds of flowers and told us in passing that those flowers came from her garden .	先生 は いろいろな 種類 の 花 を 見せて くれた ついでに 、 これらの 花 は 自分 の 家 の 庭 から 持ってきた 物 だ と 言った 。
But for the safety belt , I would n't be alive today .	もし 安全 ベルト が なかったら 、 私 は 今日 生きていない だろう 。
Man is none the happier for his wealth .	人間 は 、 裕福 だからといって 、 それだけ 幸せ と いう わけではない 。
Many people think I 'm crazy .	多く の 人 が 私 を 頭がおかしい と 思っています 。
To say is one thing , and to do is another .	言う 事 とする 事 は 別問題 だ 。
He must be a good boy .	彼 は 良い 少年 に違いない 。
It happened that I was in New York then .	その 時 私 は たまたま ニューヨーク に いた 。
The Japanese live mainly on rice .	日本人 は 主に 米 を 常食 とする 。
`` Is she coming , too ? '' `` I hope so . ''	彼女 も 来る のです か 。 来る と いい のです が 。
On my way to school each day , I see dogs .	毎日 学校 に 行く 途中 で 、 私 は 犬 を 目にする 。
They are weary of their tedious work .	あの 人達 は 退屈 な 仕事 に あきあき している のだ 。
' `` Here is my business card . Please call me anytime with more information , '' said the reporter .	「 私の 名刺 です 。 追加 情報 が あったら いつでも 連絡 下さい 」 と 記者 は 言った 。
Just right here ?	この 場所 に ？
There is no bus service to the village .	その 村 へ の バス の 便 が ない 。
A whistle involves blowing out of your mouth in a certain way .	口笛 は ある 方法 で 息 を 吹く こと で できる 。
We shall go when the rain ceases .	私達 は 雨 が やんだら 行く 。
We shall leave tomorrow morning , weather permitting .	天気 が 良ければ 、 わたしたち は 明朝 出発します 。
Why is politics separating us , when we ourselves know who is good and who is n't ?	政治 は 何だって 私たち を 分割 したい の かしら 。 私たち は 、 誰 が よい 人 で 誰 が 悪い 人 か 知っている のに 。
She 's on the rolls .	彼女 名簿 に 載っています よ 。
I am sure of his success .	彼の 成功 を 確信 している 。
Ann ca n't find a job .	アン は 仕事 が みつからない 。
You ought to see a dentist .	きみ は 歯医者 に 診て もらう べき だ 。
I greatly appreciate your advice .	助言 を 本当に 感謝 いたします 。
This house belongs to Mr Yamada .	この 家 は 山田 さん の 物 です 。
It was long before he knew it .	長い間 たって から 彼 は それ を 知った 。
She 's anxious to know the results .	彼女 は その 結果 を とても 知り たがっている 。
If you push yourself too hard , you 'll make yourself ill .	あまり 根を詰める の は 体 に 良くない よ 。
I took down her telephone number in my notebook .	僕 は 彼女の 電話 番号 を 手帳 に 書きつけた 。
His speech had an effect on our emotions .	彼の 演説 は 私達 の 感情 に 影響 を 与えた 。
I took the liberty of using the dictionary while you were out of the room .	部屋 に おられない 間 に 勝手に 辞書 を お借り しました 。
I found the book at that bookstore by chance .	あの 本屋 で たまたま その 本 を 見つけた 。
The shop is kept under police supervision .	その 店 は 警察 の 監督 のもとに ある 。
You have to have a piece of pie .	ぜひ パイ を お 召し上がり ください 。
Would you wipe the table for me ?	テーブル を ふいて くれません か 。
He is not above deceiving others to get his way .	彼 は 自分 の 思い通り に する ため なら 平気 で 人 も あざむく 。
One day an old man went fishing in the river .	ある日 、 老人 は 川 へ 魚釣り に 行った 。
Oh no , really ?	まあ 、 本当 ？
It 'll do no harm to drink a little whisky .	少々 の ウイスキー を 飲んで も 害 には なります まい 。
When listening to a lecture , you should be quiet .	講義 を 聞いている 時 は 、 静か に してい なければならない 。
The bird went up higher and higher into the sky .	その 鳥 は 高く 高く 空 へ と 登って いった 。
Take whichever one you like .	どちら でも どうぞ 。
This text is aimed at beginners .	この テキスト は 初心者 向き に できている 。
Two great civilizations slowly fell into decay .	二 大 文明 は ゆっくりと 衰退 した 。
It 's difficult to keep order in this town .	この 町 の 秩序 を 守る の は 難しい 。
Because a man whose manners are as bad as yours must try everyone 's patience .	あなた の ような 態度 には 誰だって 我慢 できません わ 。
Get off his back .	彼 へ の 非難 を やめろ 。
The theory will find general acceptance .	その 説 は 一般に 認められる だろう 。
I looked around , but saw nobody .	私 は 見回した けれど 誰も いなかった 。
He does not have anyone to play with .	彼 は 一緒に 遊ぶ 人 が いない 。
We can hardly imagine our daily life without television .	私たち は テレビ の ない 日常生活 は ほとんど 想像 も できない 。
I do n't quite know .	私 は よく 分からない んです が 。
We could n't help weeping .	私たち は 泣かない わけにはいかなかった 。
When you feel tired , there is nothing like taking a bath .	疲れた とき は 風呂 に 入る の が 一番 。
I rented a house with a garage .	私 は 車庫 付き の 家 を 借りた 。
The enemy dropped bombs on the factory .	敵 は 工場 に 爆弾 を 落とした 。
We overlook the bay from our house .	私たち の 家 から は 下 に 湾 が 見える 。
Tell me what you did on your holidays .	休暇 に 何 を した か 教えて ください 。
This meeting is a waste of time . Everybody is just talking in vague theoretical terms .	皆 、 空理空論 ばかり 言って 、 時間の無駄 だ よ 、 この 会議 は 。
His eyes shone with excitement .	彼の 目 は 興奮 して きらきら 輝いた 。
He was learning a poem .	彼 は 詩 を 暗記 していた 。
A revised edition of the encyclopedia was published .	その 百科事典 の 改訂版 が 出版 された 。
You came out of the room .	あなた が 部屋 から 出て きた 。
The end of our trouble is in sight .	私たち の もめごと も 終わり が 見えている 。
It was cloudy that night .	その 夜 は 曇り だった 。
His great learning has at last been recognized .	彼の 偉大な 学識 は ついに 認められた 。
Bill is a regular fool .	ビル は まったく の 馬鹿 だ 。
The store happened to be crowded yesterday .	その 店 は 昨日 たまたま 混雑 していた 。
Thanks to his help , my work is going well now .	彼の 援助 の おかげで 、 私の 仕事 は 現在 順調に 進んでます 。
He has a nimble mind .	彼 は 頭 の 働き が 早い 。
They suggested to him that he go alone .	彼ら は 彼 に ひとり で 行って は どう か と 提案 した 。
They go camping every summer .	彼ら は 毎年 夏 に キャンプ に 行きます 。
Mr Brown took charge of this class last year .	去年 ブラウン 先生 が この クラス を 受け持った 。
Reports are due next Monday .	レポート は 来週 の 月曜日 が 〆切 です 。
Leave it to me ; I 'll see to it that you get a full refund .	私 に まかせ なさい 。 全額 返して もらえる ように 取り計らいます よ 。
Where 's my box of chocolates ?	僕 の チョコレート は どこ だ 。
In the film , the director makes Hamlet an active person .	監督 は その 映画 で ハムレット を 活動的な 人物 に 描いている 。
The baby in the cradle is very pretty .	ゆりかご の 中 の 赤ん坊 は とても かわいい 。
Some people believe in ghosts .	幽霊 の 存在 を 信じている 人 も いる 。
The total is approximately ten thousand dollars .	合計 は １万 ドル に 近い 。
I 'll take you there .	そこ に 連れて行きます よ 。
My father gave me a puppy for my birthday .	お父さん は 誕生日 に ぼく に 小犬 を くれた 。
Your answer almost amounts to a threat .	あなた の 返答 は ほとんど 脅迫 に 等しい 。
He can speak both English and French .	彼 は 英語 と フランス語 を しゃべる ことができます 。
The boy put on his athletic shoes and ran outside .	その 少年 は 運動靴 を 履く と 、 外 へ 走って 出て行った 。
He regained consciousness in the hospital .	彼 は 病院 で 気が付いた 。
He likes to play hardball with people .	彼 は 手加減 を しない 人 です 。
A clean river flows through our town , and we can see many carp swimming in it .	私たち の 町 には きれいな 川 が 流れていて 、 たくさん の 鯉 が 泳いでいる の が 見られます 。
I lost my purse on my way to school .	学校 に 行く 途中 で 財布 を 無くした 。
The pianist is endowed with extraordinary talent .	その ピアニスト は 非凡な 才能 を 授かっている 。
Is there any reason for him to resign so suddenly ?	彼 が そんなに 突然 辞職 し なければならない 理由 が 何か ある のです か 。
He did not appear until about noon .	彼 は 昼頃 まで 姿 を 見せなかった 。
He is a fast speaker .	彼 は 早口 だ 。
The long war came to an end at last .	長かった 戦争 が やっと 終わった 。
The moon is shining bright .	月 が 澄んでいる 。
He came from behind the curtain .	彼 は カーテン の 後ろ から 出て きた 。
I sometimes wrote him a very long letter .	私 は 時々 、 彼 に とても 長い 手紙 を 書いた 。
Round trip or one-way ?	往復 ですか 、 片道 ですか 。
She burst out crying with joy when she heard the news .	彼女 は その 知らせ を 聞く と 喜び のあまり わっと 泣き出した 。
Whoo ! Today 's practice is tough - much harder than usual .	ウーッ 、 今日 の 練習 は いつになく ハード で 辛い 。
The capital of Japan is Tokyo .	日本 の 首都 は 東京 である 。
If I want to do anything , you want me to do something else .	私 が 何か を したい と 思う と 、 あなた は 別 の こと を やれ と いう 。
English is easy to learn .	英語 は 学び やすい 。
She tried to commit suicide .	彼女 は 自殺未遂 を した 。
I never eat meat .	私 は 決して 肉 を 食べません 。
Why God allows these sort of actions by Satan is explained in Job in the New Testament .	サタン の こうした 行い を 神 が なぜ 許している の か 、 その 理由 は 聖書 の ヨブ記 で 説明 されている 。
She must be tired after a long walk .	長く 歩いて 彼女 は 疲れている にちがいない 。
Make your bed .	ベッドメイキング を し なさい 。
They crept forward .	彼ら は 前方 へ はって 進んで いった 。
Can you do some shopping for me ?	買い物 を して きて くれる ？
I 've seen that picture before .	その 絵 を 以前に 見た ことがある 。
Roughly speaking , there were about 30 people in the bus .	大雑把に 言えば 、 バス には ３０ 名 ほど の 人達 が いました 。
I want to buy another .	別 な の を 買い たい 。
They look happy today .	彼ら は 今日 幸せ そう に 見える 。
We believed it to be a flying saucer .	空飛ぶ円盤 だ と 思った 。
Why did you live in Kyoto last year ?	あなた は 何故 去年 京都 に 住んでいた のです か 。
To her embarrassment , her baby never stopped crying .	彼女 が 当惑 した こと に 赤ん坊 は とうとう 泣き やまなかった 。
She 's writing something in her study .	彼女 は 書斎 で 何か 書き物 を している 。
I wanted to have had everything my own way .	私 は 何でも 自分 の したい 放題 に したかった のに 。
The incident was etched in his memory .	その 出来事 は 彼 の 記憶 に 刻み込まれた 。
Let 's take a picture .	写真を撮ろう 。
She picked out three beautiful apples .	彼女 は きれいな りんご を ３つ 選んだ 。
Automobile production has peaked out .	自動車 生産 は 頂点 を 超えた 。
We have seen three wars .	わたしたち は 戦争 を さんかい 経験 した 。
He asked for food .	彼 は 食物 を くれ と 頼んだ 。
I have another friend in China .	私 は もうひとり 中国 の 友達 を 持っている 。
I ran as fast as I could .	私 は 出来るだけ 速く 走った 。
I have a slight fever .	私 は 少し 熱 が ある 。
The kids are asleep .	子供達 は 眠っている よ 。
Never did I dream of winning first prize .	１等 になる なんて 夢にも 思わなかった 。
A good idea came across my mind .	よい 考え が 私の 心に浮かんだ 。
She can not but laugh .	彼女 は 笑わ ざるを得ない 。
She was born at six a.m. on July 17 , 1990 .	彼女 は １９９０ 年 ７月 １７ 日 の 午前 ６ 時 に 生まれた 。
Let 's meet up somewhere .	どこか で 会いましょう 。
Are there any detergents in the laundry ?	ランドリー には 洗剤 が あります か 。
The dictionary contains about half a million words .	その 事典 は 約 ５０ 万 語 の 単語 を 収めている 。
They got out of the car .	彼ら は 車 から おりた 。
Smoking may be harmful to his heart .	煙 は 彼 の 心臓 に よくない かもしれない 。
The directors were reluctant to undertake so risky a venture .	役員 達 は そんな 危険な 事業 に 乗り出す の を しぶった 。
I 've steeled myself to face a certain amount of sacrifice , effort and hardship if that 's what it takes to fulfill my dream .	夢 を 叶える ために は ある程度 の 犠牲 ・ 努力 ・ 苦労 は 覚悟 している 。
I 'd like to pay by credit card .	クレジットカード で 支払い たい のです が 。
Jane and I play the piano very well .	ジェーン と 私 は ピアノ を 上手に ひく 。
We accept all major credit cards .	主な クレジットカード は 全て ご 利用 いただけます 。
Do you think he made that mistake on purpose ?	君 は 彼 が わざと その 間違い を した と 思う かい 。
He had a notion that she was very angry with him .	彼 は 彼女 が 彼 の こと を とても 怒っている と 考えていた 。
He sent me a letter of appreciation .	彼 は 僕 に 礼状 を 送って くれた 。
Picasso is a famous artist .	ピカソ は 有名な 画家 です 。
Clarity comes first .	明確さ が 一番 大事 です 。
There is a lack of communication between the young and the old .	若者 と 老人 の 間 には コミュニケーション の 欠如 が ある 。
Wo n't you have some more coffee ?	もう少し コーヒー は いかが ですか 。
She may well be ashamed of her old clothes .	彼女 が 自分 の 古い 服 を 恥ずかしがる の も もっとも だ 。
It is raining worse than ever .	雨 が ますます ひどく 降っている 。
The police arrested the suspect yesterday .	警察 は 昨日 その 容疑者 を 逮捕 した 。
You have good taste in music .	音楽 の 趣味 が いい ね 。
Your dress is unsuitable for the occasion .	君の 服装 は 場所 に そぐわない 。
I never see that picture without being reminded of my hometown .	その 絵 を 見る と 必ず 故郷 を 思い出します 。
The ship came in sight .	その 船 が 見えて きた 。
His statement was based on the fact .	彼の 陳述 は 事実 に 基づいていた 。
The sailors perished in the sea .	水夫 たち は 海 の もくず と 消え去った 。
This is all he has to do .	これだけ の こと を 彼 は やらなければならない 。
I can hardly hold my own against his daring .	彼の 心臓 には 顔負け だ 。
She forgot her umbrella , as is often the case with her .	よくあることだが 、 彼女 は 傘 を 忘れた 。
I usually go to bed at ten .	わたし は 普通 は １０ 時 に 寝ます 。
I glare resentfully at the crimson letter , is this the infamous red-paper draft notice ?	真っ赤な 手紙 を 忌々し げ に 見つめ 、 これ が 悪名高い 赤紙 って ヤツ な の か ？
No sooner had we sat down than she brought us coffee .	私たち が 座る と すぐに 彼女 は コーヒー を 持ってきた 。
According to the X-ray , everything is all right .	レントゲン の 検査 結果 で は 何も 問題 は ありません 。
I owe her 100,000 yen .	私 は 彼女 に １０ 万 円 の 借金 を している 。
He contemplated taking a trip to Paris .	彼 は パリ へ 行こう と もくろんでいた 。
She is working night and day .	彼女 は 昼 も 夜 も 働いている 。
This moment will be recorded in history .	この 瞬間 は 歴史 に 記録 される だろう 。
She did n't play cards , because she did n't like it .	彼女 は トランプ が すき ではなかった ので しなかった 。
I found her letter in the mailbox .	彼女 から の 手紙 が 郵便受け に はいっていた 。
They charge tax on liquor in the U.S.	米国 で は 酒類 に 税金 を かける 。
You should not leave the baby alone .	赤ちゃん を 一人 に して おいて は いけません 。
The poor girl went out of her mind .	かわいそうに 、 あの 女の子 は 気が狂って しまった 。
We must try to protect the environment .	私たち は 環境 を 守る ように 努力 し なくてはならない 。
She came home very late .	彼女 は とても 遅く 帰宅 した 。
Ten policemen were assigned to patrol that area .	１０ 人 の 警官 が その 地域 の パトロール に ついた 。
In spring , everyone wakes up early .	春 になると 、 誰も が 早く 目を覚まします 。
Ken 's father loved Ken all the more because he was his only son .	ケン は １人 息子 なので 、 父親 は 一層 可愛がった 。
I lead a regular life .	私 は 規則的な 生活 を しています 。
I left my umbrella on the train .	電車 に 傘 を 忘れた 。
I saw a man with a child .	私 は こども を 連れた 人 に 会いました 。
I guess I 'm never going to get married .	これ じゃあ 、 僕 は 一生 結婚 なんて 出来 やしない や 。
Do n't worry about that .	そんな の 気にしないで 。
She took full advantage of the opportunity .	彼女 は 機会 を 十分 に 利用 した 。
I 'm sure that he 'll come on time .	彼 は きっと 時間どおりに 来る 。
He usually goes to McDonald 's .	彼 は たいてい マクドナルド に 行く 。
Give us a true account of what happened .	事件 の 真相 を 話して ください 。
Anything can happen in the world of dreams .	夢 の 世界 で は どんな こと でも 起こりうる 。
You must never resort to violence .	絶対に 暴力に訴えて は いけません 。
With the token they could only go to the company shop and buy food or clothing from that shop .	この 代用 貨幣 で は 、 会社 の 直営店 に 行き 、 その 店 で 食料品 や 衣料 を 買う こと しか で きませんでした 。
You should n't judge a person by his looks .	人 を 外見 で 判断 すべき ではない 。
Heavy sound is being looked for .	ヘヴィな サウンド が 求められている 。
How would you like your coffee ?	コーヒー に 何か 入れます か 。
After they argued , they did n't speak to each other for a week .	議論 した 後 、 彼ら は 互いに １週間 も 口をきかなかった 。
She does n't care about her dress .	彼女 は 服装 に 気を使わない 。
A few people came to the lecture .	その 講義 へ 来た 人 は 少し は いた 。
He persuaded his wife not to divorce him .	彼 は 妻 に 離婚 しないで くれ と 説得 した 。
It is said that his father died in a foreign country .	彼の お父さん は 外国 で 死んだ のだ そうだ 。
I am looking forward to your letter .	あなた の 手紙 を 私 は 楽しみに待っています 。
The movie moved her to tears .	その 映画 を みて 彼女 は 泣いて しまった 。
What are you going to do about it ?	どう する つもり なんだ ？
The bandits demanded all money in the register .	悪漢 は 金銭 登録 機 の お金 を 要求 した 。
Carol often watches horror movies .	キャロル は よく 恐怖映画 を 見る 。
That red sweater looks good on you .	あの 赤い セーター は あなた に 似合います よ 。
Please bring me two pieces of chalk .	チョーク を 二 本 持ってきて ください 。
I was quite at a loss for words .	私 は 大変 当惑 し 言葉 が でなかった 。
How can I get to the station ?	駅 へ は どう いけば よい のです か 。
It 's a sop to Cerberus .	役人 へ の 袖の下 だ よ 。
Fatigue is undermining his health .	疲労 が 彼の 健康 を むしばんでいる 。
I will .	僕 が やります 。
In the north it is cold in winter .	北の方 で は 冬 が 寒い です 。
Ayumi 's feet were fanned by the river wind .	亜由美 ちゃん の 足 が 河風 の 煽り を 受けていた 。
Just because he likes painting does n't mean he 's good at it .	彼 が 絵 が 好き だからといって 絵 が うまい と いう こと には ならない 。
The character of men depends more on their occupations than on any teaching we can give them .	人々 の 性格 は 彼ら に 与え 得る 、 いかなる 教え よりも  、 その 職業 に 基づく 。
They drank a bottle of red wine at dinner .	彼ら は 夕食 で 赤ワイン を １ びん 飲んだ 。
If I thought I could get away with it , I would n't pay tax at all .	もし それ が 許される と 知っていたら 、 私 は 税金 など 払わなかった だろう 。
I have a spare key to my house hidden outside .	外 の 隠れ家 の スペアキー を 持っている 。
The circus entertained us very much .	その サーカス は 私たち を 大変 楽しませて くれた 。
The speaker referred to his notes every few minutes .	講演者 は 数分後 と に メモ を 参照 した 。
I am not myself , my usual self having caught a cold .	風邪を引いて 本調子 ではない 。
I said `` good night '' to my parents and went to bed .	私 は 両親 に 「 おやすみなさい 」 を 言って 床についた 。
The eastern sky was getting light .	東 の 空 が 白み 始めていた 。
I finally gave up smoking .	私 は とうとう タバコをやめた 。
The furniture belongs to my mother .	その 家具 は 母 の 物 です 。
Each individual paid 1,000 dollars .	一人あたり 千 ドル 払った 。
Bad money drives out good .	悪貨 は 良貨 を 駆逐 する 。
I am clever , sensitive and imaginative .	私 は 頭 が よく 、 敏感 で 想像力 に 富んでいます 。
I like Japanese rice pillows ; they are good for my neck .	私 は 日本 の 米 枕 が 好き です 。 とても 首 に 良い です 。
She is a good writer .	彼女 は 文章 が うまい 。
The U.S. is a service economy .	アメリカ は サービス 経済 の 国 だ 。
The boughs of the large tree overhung the pond .	その 巨木 の 枝 が 池 に 覆いかぶさっていた 。
Misako married a Canadian last June .	ミサコ は この前の ６月 に カナダ 人 と 結婚した 。
Yes , I went yesterday .	ええ 、 昨日 行った わ 。
Do n't climb up the wall .	塀 に 登る な 。
Many people attended that conference .	その 会議 には たくさん の 人 が 出席 していた 。
All of them remained silent .	彼ら は みんな 黙った まま だった 。
I go to bed late at night .	私 は 夜 遅く に 寝ます 。
They have fixed to go to London .	彼ら は ロンドン へ 行く こと に 決めた 。
The group is made up of six members .	その グループ は ６ 人 の メンバー で 成り立っている 。
Everything about him was gray .	彼 の 回り の すべての 物 が 灰色 でした 。
I am sure that Jim made up that story .	ぼく は きっと ジム が その 話 を でっち上げた のだ と 思う 。
I 'm about tired of this quiet life .	この 静かな 生活 には いい加減 飽きて しまった 。
We should hold some of food in reserve .	私達 は その 食料 の うちの 少し を 予備 に 取って おく べき だ 。
I hear that his father is abroad .	彼の お父さん は 外国 に いる そうだ 。
What is the main cause of the crime ?	その 犯罪 の 第一 の 要因 は 何 ですか 。
Clean your room .	自分 の 部屋 を 掃除 し なさい 。
The ship was at the mercy of the waves .	船 は 波 の なすがまま であった 。
That house is very small .	あの 家 は 大変 小さい 。
Forks were used for many years in Europe and the Near East , but only for cooking .	フォーク は 、 ヨーロッパ や 近東 地域 で 長年 にわたって 使われていた が 、 それ は もっぱら 調理 用 に のみ であった 。
She is a woman with a classical education .	彼女 は 古典 の 教育 を 受けている 。
May I see your passport ?	パスポート を 拝見 して よろしい ですか 。
I have a strong backhand .	俺 は バック で 打つ 方 が 得意 だ な 。
I have visited Sapporo several times on business .	札幌 は 仕事 で 何度か 行った ことがある 。
My son often worries me by asking a lot of questions .	息子 は たくさん の 質問をして 私 を 悩ませる こと が よくある 。
It is impossible for him to do it .	彼 が それ を する の は 不可能 だ 。
This dog is our regimental mascot .	この 犬 は 我が 連隊 の マスコット だ 。
I want it with plenty of ice .	氷 を たくさん いれて 下さい 。
Well , what happened to her ?	それで 彼女 は どう なりました か 。
The house did not suffer much damage because the fire was quickly put out .	火 は すぐに 消された ので 、 その 家 は あまり 被害を受けなかった 。
I may have left them behind in the train .	私 は 電車 の 中 に 置き忘れた の かもしれない 。
What do you say to going swimming tomorrow ?	明日 、 泳ぎ に 行こう よ 。
The price was absurdly high .	値段 は お 話にならない ほど 高かった 。
A gentleman would not do such a thing .	紳士 で あれば 、 そんな こと は しない でしょう 。
I need your help .	私 は 君の 助力 が 必要 だ 。
Take your time .	ゆっくり やって くれ 。
He borrowed a lot of money from the bank .	彼 は 銀行 から 多額 の 金 を 借りた 。
I enjoyed swimming .	私 は 泳ぐ の を 楽しんだ 。
Example is better than precept .	実例 は 教訓 に まさる 。
The baby soon fell asleep in the cradle .	その 赤ん坊 は 揺りかご の 中 で すぐ 眠って しまった 。
We must surrender them all .	すべて 主に お返し します 。
I reached my destination in a week .	私 は １週間 で 目的地 に ついた 。
She prepared herself for the tennis match by practicing for hours every day .	彼女 は 毎日 何時間 も 練習 して テニス の 試合 に 備えた 。
Do your parents agree to your becoming a flight attendant ?	あなた の 両親 は あなた が スチュワーデス になる こと に 同意 して くれています か 。
He is something of an expert on oriental art .	彼 は 東洋 芸術 の かなり の 専門家 だ 。
His words convey nothing at all to me .	彼の 言う こと は 私 には 何の こと か さっぱり わからない 。
If I were in your place , I would not do so .	もし 私 が 君の 立場 だったら 、 そう は しない だろう 。
The inhabitants of the island are friendly .	その 島 の 住民 は 友好的 だ 。
Jiro wants to drink Coke .	次郎 は コカ・コーラ が 飲み たい と 思っている 。
I gave up the idea of seeing the sights of the city because of the bad weather .	悪天候 だった ので 市内 見物 を 断念 した 。
How far is it from the airport to the hotel ?	空港 から ホテル まで どのくらい あります か 。
Their progress was stopped by a wide river .	彼ら は 大きな 川 に 前進 を 阻まれた 。
We all know that no one is perfect .	私達 は みんな だれ一人として 完璧な 人間 は いない こと は 分かっている 。
Psycho-horror films dealing with the mysteries of human psychology are popular these days .	近年 で は 人間心理 の 謎 を 扱う サイコ ホラー も 人気 である 。
It 's too much of a nuisance .	手に負えない ほど やっかいな こと です 。
He fell in love with her at first sight .	彼 は 一目 見て 彼女 に 恋をした 。
The thief ran away when she saw the policeman .	泥棒 は 警官 を 見る と 逃げ出した 。
I must pull myself together to overcome this incident .	わたし は この 出来事 を 乗り越える ために しっかり し なければならない 。
How beautiful and free the cranes were ! Sadako sighed and closed her eyes .	鶴 たち は 何と 美しく 自由 な ん でしょう 。 禎子 は ため息をついて 、 目 を 閉じた 。
Which wine goes best with red meat ?	肉 に 合う ワイン は どれ ですか 。
You really like comic books , do n't you ?	ほんとに 君 は 漫画 が 好き だ ね 。
We owed our success to their help .	私達 の 成功 は 彼らの 助力 の おかげ だ 。
A lot of people want peace all over the world .	世界 の いたる所 で 多く の 人々 が 平和 を 望んでいる 。
While Adam was rock-climbing , he fell and broke his leg .	アダム は 岩登り を している 時 に 、 落下 して あし を 折りました 。
I want to see the scene in slow motion .	その 場面 を スローモーション で 見 たい 。
By the way , would you like to come and see my mother ?	ところで 、 家 に 来て 私の 母 に 会います か 。
That is a fine fix you have got us into .	おまえ さん の おかげで 私達 は ひどい目にあわされた 。
Who discovered America ?	誰 が アメリカ を 発見 した のです か 。
I 'm facing that problem , myself .	私 は その 問題 に 直面 している 。
He killed the goose , foolishly .	彼 は おろか にも がちょう を 殺した 。
She greeted me with a smile .	彼女 は 微笑んで 私 を 迎えて くれた 。
I 'd like to be left alone for a while , if you do n't mind .	よろしかったら 、 しばらく 一人 に して 欲しい のです が 。
If you get up early , you can be in time for school .	早く 起きれば 、 あなた は 授業 に 間に合います 。
